1111111111
1P0C0100C1
1111000101
10010C0101
1000001111
1C00101001
101010C001
1110111101
10C000E1C1
1111111111
