1111111111111
1P0C0100C0001
11110001000C1
10010C0100001
1000001110001
1C00101000111
101010C000001
1110111100C01
10C000E1C0001
1111111111111
