111111111111111111111
1P0000000000C00000001
111111111111111111101
1C00000000C0000000001
101111111111111111111
1000000C00000000000E1
111111111111111111111
